NO ./textures/sprt.xpm
SO ./textures/banner.xpm
WE ./textures/redbrick.xpm
EA ./textures/bluestone.xpm

F  50,125,50
C  55,100,200

111111111111111111111111111111111
111111111000000000110000000000001
111111111011000001110000000000001
111111111001000000000000000000001
111111111011000001110000000000001
10000000001D100000111011111111111
1111011111111D1101110000001000111
111101111111110111010100100011111
  1100000001101110111111111111
100001D10000100011000000100011111
100000000000000011010100100011111
110000010101010111110111101011111
111101111111010111011110111111111
1W0000000000110000000000001111111
111111111111111111111111111111111