NO ./textures/sprt.xpm
SO ./textures/banner.xpm
WE ./textures/redbrick.xpm
EA ./textures/bluestone.xpm

F  50,125,50
C  55,100,200

111111111111111111111111111111111
111111111000000000110000000111001
111111111011000001110000000111001
111111111001000000000000000111001
111111111011000001110000000111001
1000000000D1000001110111111111001
1111011111111D1101110000001111001
111101111111110111010100100111001
  1100000001101110111111111111001
100001D10000100011000000100111001
100000000000000011010100100111001
110000010101010111110111101111001
111101111111010111011110111111001
1000000W0000110000000000001111001
111111111111111111111111111111111
                            